R 1920 1080
NO    ./path_to_the_north_texture
SO    ./path_to_the_south_texture
WE    ./path_to_the_west_texture
EA    ./path_to_the_east_texture
S     ./path_to_the_sprite_texture
F     232,84,67
C     108,11,0

111111111111
100001000001
100000000001
100000000001
110000000001
100000000011
110000S00011
100000000011
110000000001
100000000001
100000000001
111111111111