R 1920 1080
B     ./srcs/skybox-2.xpm
NO    ./srcs/stain1.xpm
SO    ./srcs/stain2.xpm
WE    ./srcs/stain4.xpm
EA    ./srcs/stain3.xpm
S     ./srcs/kaganawa.xpm
F     0,0,0
C     255,255,255

11111111111111111
10010010001000101
10000000000000001
12100000000011111
12000000N00000011
10100000000000211
12000000000000011
11100020000000011
11111111111111111